くらなど	クラナド	固有名詞	Clannadの題名、カタカナ表記
くらなど	Clannad	アルファベット	Clannadの題名、アルファベット表記
さくらまいちるさかみちで	桜舞い散る坂道で	固有名詞	Clannad副題、第1話
さいしょのいっぽ	最初の一歩	固有名詞	Clannad副題、第2話
なみだのあとにもういちど	涙のあとにもう一度	固有名詞	Clannad副題、第3話
なかまをさがそう	仲間をさがそう	固有名詞	Clannad副題、第4話
ちょうこくのあるふうけい	彫刻のある風景	固有名詞	Clannad副題、第5話
あねといもうとのそうりつしゃさい	姉と妹の創立者祭	固有名詞	Clannad副題、第6話
ほしがたのきもち	星型の気持ち	固有名詞	Clannad副題、第7話
たそがれにきえるかぜ	黄昏に消える風	固有名詞	Clannad副題、第8話
ゆめのさいごまで	夢の最後まで	固有名詞	Clannad副題、第9話
てんさいしょうじょのちょうせん	天才少女の挑戦	固有名詞	Clannad副題、第10話
ほうかごのきょうそうきょく	放課後の狂想曲	固有名詞	Clannad副題、第11話
かくされたせかい	かくされた世界	固有名詞	Clannad副題、第12話
おもいでのにわを	思い出の庭を	固有名詞	Clannad副題、第13話
せおりーおぶえぶりしんぐ	Theory of Everything	固有名詞	Clannad副題、第14話
こまったもんだい	困った問題	固有名詞	Clannad副題、第15話
すりーおんすりー	3 on 3	固有名詞	Clannad副題、第16話
ふざいのくうかん	不在の空間	固有名詞	Clannad副題、第17話
ぎゃくてんのひさく	逆転の秘策	固有名詞	Clannad副題、第18話
あたらしいせいかつ	新しい生活	固有名詞	Clannad副題、第19話
ひめられたかこ	秘められた過去	固有名詞	Clannad副題、第20話
がくえんさいにむけて	学園祭にむけて	固有名詞	Clannad副題、第21話
かげふたつ	影二つ	固有名詞	Clannad副題、最終回
なつやすみのできごと	夏休みの出来事	固有名詞	Clannad副題、番外編
もうひとつのせかいともよへん	もうひとつの世界 智代編	固有名詞	Clannad副題、番外編
なつのおわりのさよなら	夏の終わりのサヨナラ	固有名詞	Clannad AS副題、第1話
いつわりのあいをさがして	いつわりの愛をさがして	固有名詞	Clannad AS副題、第2話
すれちがうこころ	すれちがう心	固有名詞	Clannad AS副題、第3話
あのひとおなじえがおで	あの日と同じ笑顔で	固有名詞	Clannad AS副題、第4話
きみのいたきせつ	君のいた季節	固有名詞	Clannad AS副題、第5話
ずっとあなたのそばに	ずっとあなたのそばに	固有名詞	Clannad AS副題、第6話
かのじょのいばしょ	彼女の居場所	固有名詞	Clannad AS副題、第7話
ゆうきあるたたかい	勇気ある闘い	固有名詞	Clannad AS副題、第8話
さかみちのとちゅう	坂道の途中	固有名詞	Clannad AS副題、第9話
はじまりのきせつ	始まりの季節	固有名詞	Clannad AS副題、第10話
やくそくのそうりつしゃさい	約束の創立者祭	固有名詞	Clannad AS副題、第11話
とつぜんのできごと	突然の出来事	固有名詞	Clannad AS副題、第12話
そつぎょう	卒業	固有名詞	Clannad AS副題、第13話
あたらしいかぞく	新しい家族	固有名詞	Clannad AS副題、第14話
なつのなごりに	夏の名残りに	固有名詞	Clannad AS副題、第15話
しろいやみ	白い闇	固有名詞	Clannad AS副題、第16話
なつじかん	夏時間	固有名詞	Clannad AS副題、第17話
だいちのはて	大地の果て	固有名詞	Clannad AS副題、第18話
いえじ	家路	固有名詞	Clannad AS副題、第19話
しおかぜのたわむれ	汐風の戯れ	固有名詞	Clannad AS副題、第20話
せかいのおわり	世界の終わり	固有名詞	Clannad AS副題、第21話
ちいさなてのひら	小さな手のひら	固有名詞	Clannad AS、最終回
いちねんまえのできごと	一年前の出来事	固有名詞	Clannad AS副題、番外編
もうひとつのせかいきょうへん	もうひとつの世界 杏編	固有名詞	Clannad AS副題、番外編
みどりのきのしたで	緑の樹の下で	固有名詞	Clannad AS副題、総集編
おかざきともや	岡崎朋也	人名	Clannad、登場人物
ふるかわなぎさ	古河渚	人名	Clannad、登場人物
ふじばやしきょう	藤林杏	人名	Clannad、登場人物
いちのせことみ	一ノ瀬ことみ	人名	Clannad、登場人物
さかがみともよ	坂上智代	人名	Clannad、登場人物
いぶきふうこ	伊吹風子	人名	Clannad、登場人物
みやざわゆきね	宮沢有紀寧	人名	Clannad、登場人物
ふじばやしりょう	藤林椋	人名	Clannad、登場人物
すのはらようへい	春原陽平	人名	Clannad、登場人物
さがらみさえ	相楽美佐枝	人名	Clannad、登場人物
しまかつき	志麻賀津紀	人名	Clannad、登場人物
こうむらとしお	幸村俊夫	人名	Clannad、登場人物
すのはらめい	春原芽衣	人名	Clannad、登場人物
ひいらぎかっぺい	柊勝平	人名	Clannad、登場人物
ふるかわあきお	古河秋夫	人名	Clannad、登場人物
ふるかわさなえ	古河早苗	人名	Clannad、登場人物
いぶきこうこ	伊吹公子	人名	Clannad、登場人物
よしのゆうすけ	芳野祐介	人名	Clannad、登場人物
おかざきなおゆき	岡崎直幸	人名	Clannad、登場人物
おかざきなぎさ	岡崎渚	人名	Clannad、登場人物、旧姓：古河
おかざきしの	岡崎史乃	人名	Clannad、登場人物
おかざきうしお	岡崎汐	人名	Clannad、登場人物
なぞのしょうじょ	謎の少女	人名	Clannad、登場人物
がらくたのにんぎょう	ガラクタの人形	人名	Clannad、登場人物
