しんく	シンク	名	DOG DAYSのキャラクター
しんくいずみ	シンク・イズミ	人名	DOG DAYSのキャラクター
れべっか	レベッカ	名	DOG DAYSのキャラクター
べっきー	ベッキー	名	DOG DAYSのキャラクター、レベッカ・アンダーソンの愛称
れべっかあんだーそん	レベッカ・アンダーソン	人名	DOG DAYSのキャラクター
ななみ	ナナミ	名	DOG DAYSのキャラクター
ななみたかつき	ナナミ・タカツキ	人名	DOG DAYSのキャラクター
たかつきななみ	高槻七海	人名	DOG DAYSのキャラクター
たかつき	高槻	姓	DOG DAYSのキャラクター
ななみ	七海	名	DOG DAYSのキャラクター
みるひ	ミルヒ	名	DOG DAYSのキャラクター
みるふぃおーれふぃりあんのびすこってぃ	ミルフィオーレ・フィリアンノ・ビスコッティ	人名	DOG DAYSのキャラクター
みるふぃおーれ	ミルフィオーレ	名	DOG DAYSのキャラクター
びすこってぃきょうわこく	ビスコッティ共和国	地名	DOG DAYSの地名
びすこってぃきしだん	ビスコッティ騎士団	組織	DOG DAYS、ビスコッティ共和国の騎士団
えくれーるまるてぃのっじ	エクレール・マルティノッジ	人名	DOG DAYSのキャラクター
えくれ	エクレ	名	DOG DAYSのキャラクター、エクレール・マルティノッジの愛称
ろらんまるてぃのっじ	ロラン・マルティノッジ	人名	DOG DAYSのキャラクター
えみりおあらしーど	エミリオ・アラシード	人名	DOG DAYSのキャラクター
あんじゅ	アンジュ	人名	DOG DAYSのキャラクター
りこったえるまーる	リコッタ・エルマール	人名	DOG DAYSのキャラクター
りこ	リコ	名	DOG DAYSのキャラクター、リコッタ・エルマールの愛称
げんろういん	元老院	組織	DOG DAYSにおける役職名
あめりたとらんぺ	アメリタ・トランペ	人名	DOG DAYSのキャラクター
りぜるこんきりえ	リゼル・コンキリエ	人名	DOG DAYSのキャラクター
ふうげつあん	風月庵	地名	DOG DAYSの地名
ぶりおっしゅだるきあん	ブリオッシュ・ダルキアン	人名	DOG DAYSのキャラクター
だるきあんきょう	ダルキアン卿	人名	DOG DAYSのキャラクター、ブリオッシュ・ダルキアン
ゆきかぜぱねとーね	ユキカゼ・パネトーネ	人名	DOG DAYSのキャラクター
ゆっきー	ユッキー	名	DOG DAYSのキャラクター、ユキカゼ・パトローネの愛称
いすかまきしま	イスカ・マキシマ	人名	DOG DAYSのキャラクター
えいか	エイカ	人名	DOG DAYSのキャラクター
かなた	カナタ	人名	DOG DAYSのキャラクター
たつまき	タツマキ	人名	DOG DAYSのキャラクター
ほむら	ホムラ	人名	DOG DAYSのキャラクター
このは	コノハ	人名	DOG DAYSのキャラクター
ぱーしーがうでぃ	パーシー・ガウディ	人名	DOG DAYSのキャラクター
えびーたされす	エビータ・サレス	人名	DOG DAYSのキャラクター
れおんみしぇりがれっとでろわ	レオンミシェリ・ガレット・デ・ロワ	人名	DOG DAYSのキャラクター
れお	レオ	名	DOG DAYSのキャラクター、レオンミシェリ・ガレット・デ・ロワの愛称
がうるがれっとでろわ	ガウル・ガレット・デ・ロワ	人名	DOG DAYSのキャラクター
がう	ガウ	名	DOG DAYSのキャラクター、ガウル・ガレット・デ・ロワの愛称
ごどうぃんどりゅーる	ゴドウィン・ドリュール	人名	DOG DAYSのキャラクター
ばなーどさぶらーじゅ	バナード・サブラージュ	人名	DOG DAYSのキャラクター
ちぇいにー	チェイニー	名	DOG DAYSのキャラクター
のわーるう゛ぃのかかお	ノワール・ヴィノカカオ	人名	DOG DAYSのキャラクター
のわ	ノワ	名	DOG DAYSのキャラクター、ノワール・ヴィノカカオの愛称
じょーぬくらふてぃ	ジョーヌ・クラフティ	人名	DOG DAYSのキャラクター
じょー	ジョー	名	DOG DAYSのキャラクター、ジョーヌ・クラフティ
びおれあまれっと	ビオレ・アマレット	人名	DOG DAYSのキャラクター
るーじゅぴえすもんて	ルージュ・ピエスモンテ	人名	DOG DAYSのキャラクター
ふらんぼわーずしゃるれー	フランボワーズ・シャルレー	人名	DOG DAYSのキャラクター
じゃんかぞーに	ジャン・カゾーニ	人名	DOG DAYSのキャラクター
くーべるえっしぇんばっはぱすてぃやーじゅ	クーベル・エッシェンバッハ・パスティヤージュ	人名	DOG DAYSのキャラクター、クーベル・エッシェンバッハ・パスティヤージュ
くーべる	クーベル	名	DOG DAYSのキャラクター
きゃらうぇいりすれ	キャラウェイ・リスレ	人名	DOG DAYSのキャラクター
りーしぇあんろーべ	リーシェ・アンローベ	人名	DOG DAYSのキャラクター
かりんまくだねる	カリン・マクダネル	人名	DOG DAYSのキャラクター
あでらいどぐらんまにえ	アデライド・グランマニエ	人名	DOG DAYSのキャラクター
あでる	アデル	名	DOG DAYSのキャラクター
う゛ぁれりあかるばどす	ヴァレリア・カルバドス	人名	DOG DAYSのキャラクター
う゛ぁれりー	ヴァレリー	名	DOG DAYSのキャラクター、ヴァレリア・カルバドスの愛称
しょうかんのぎ	召喚の儀	名詞	DOG DAYSの用語
そうかんのぎ	送還の儀	名詞	DOG DAYSの用語
ふろにゃるどご	フロニャルド語	固有名詞	DOG DAYSの用語
ふろにゃもじ	フロニャ文字	名詞	DOG DAYSの用語
きれき	輝歴	名詞	DOG DAYSの用語
ほうけん	宝剣	名詞	DOG DAYSの用語
ぱらでぃおん	パラディオン	固有名詞	DOG DAYSの用語
えくせりーど	エクセリード	固有名詞	DOG DAYSの用語
ぐらんう゛ぇーる	グランヴェール	固有名詞	DOG DAYSの用語
えくすまきな	エクスマキナ	固有名詞	DOG DAYSの用語
くるまるす	クルマルス	固有名詞	DOG DAYSの用語
めるくりうす	メルクリウス	固有名詞	DOG DAYSの用語
えいゆうけっしょう	英雄結晶	固有名詞	DOG DAYSの用語
まじんけっしょう	魔人結晶	固有名詞	DOG DAYSの用語
せるくる	セルクル	固有名詞	DOG DAYSの用語
ぶらんしーる	ブランシール	固有名詞	DOG DAYSの用語
けものだま	けものだま	固有名詞	DOG DAYSの用語
とちがみ	土地神	固有名詞	DOG DAYSの用語
ふろにゃしゅうは	フロニャ周波	固有名詞	DOG DAYSの用語
ふろにゃちから	フロニャ力	固有名詞	DOG DAYSの用語
もんしょう	紋章	名詞	DOG DAYSの用語
きりょく	輝力	名詞	DOG DAYSの用語
もんしょうじゅつ	紋章術	名詞	DOG DAYSの用語
もんしょうほう	紋章砲	名詞	DOG DAYSの用語
もんしょうけん	紋章剣	名詞	DOG DAYSの用語
ほしよみ	星詠み	名詞	DOG DAYSの用語
しょうじゅつ	晶術	名詞	DOG DAYSの用語
まもの	魔物	名詞	DOG DAYSの用語
ようとう	妖刀	名詞	DOG DAYSの用語
まがたち	禍太刀	名詞	DOG DAYSの用語
ゆにおんふぇすた	ユニオン・フェスタ	固有名詞	DOG DAYSの用語
あいあんあすれちっく	アイアンアスレチック	固有名詞	DOG DAYSの用語
はちぇすたーくろくま	ハチェスター黒熊	固有名詞	DOG DAYSの用語
