がーるずあんどぱんつぁー	ガールズ&パンツァー	固有名詞	ガールズ&パンツァー
せんしゃどうはじめます	戦車道、始めます!	固有名詞	ガールズ&パンツァー副題、第1話
せんしゃのります	戦車、乗ります!	固有名詞	ガールズ&パンツァー副題、第2話
しあいやります	試合、やります!	固有名詞	ガールズ&パンツァー副題、第3話
たいちょうがんばります	隊長、がんばります!	固有名詞	ガールズ&パンツァー副題、第4話
きょうごうしゃーまんぐんだんです	強豪・シャーマン軍団です!	固有名詞	ガールズ&パンツァー副題、第5話
しょうかいします	紹介します!	固有名詞	ガールズ&パンツァー副題、第5.5話
いっかいせんはくねつしてます	一回戦、白熱してます!	固有名詞	ガールズ&パンツァー副題、第6話
つぎはあんつぃおです	次はアンツィオです!	固有名詞	ガールズ&パンツァー副題、第7話
ぷらうだせんです	プラウダ戦です!	固有名詞	ガールズ&パンツァー副題、第8話
ぜったいぜつめいです	絶対絶命です!	固有名詞	ガールズ&パンツァー副題、第9話
くらすめいとです	クラスメイトです!	固有名詞	ガールズ&パンツァー副題、第10話
しょうかいします2	紹介します 2!	固有名詞	ガールズ&パンツァー副題、第10.5話
にしずみみほ	西住みほ	人名	ガールズ&パンツァーのキャラクター
みぽりん	みぽりん	名	ガールズ&パンツァー、西住みほの愛称
たけべさおり	武部沙織	人名	ガールズ&パンツァーのキャラクター
いすずはな	五十鈴華	人名	ガールズ&パンツァーのキャラクター
あきやまゆかり	秋山優花里	人名	ガールズ&パンツァーのキャラクター
れいぜいまこ	冷泉麻子	人名	ガールズ&パンツァーのキャラクター
ゆかりん	ゆかりん	名	ガールズ&パンツァー、秋山優花里の愛称
かどたにあんず	角谷杏	人名	ガールズ&パンツァーのキャラクター
こやまゆず	小山柚子	人名	ガールズ&パンツァーのキャラクター
かわしまもも	河嶋桃	人名	ガールズ&パンツァーのキャラクター
いそべのりこ	磯辺典子	人名	ガールズ&パンツァーのキャラクター
こんどうたえこ	近藤妙子	人名	ガールズ&パンツァーのキャラクター
かわにししのぶ	河西忍	人名	ガールズ&パンツァーのキャラクター
ささきあけび	佐々木あけび	人名	ガールズ&パンツァーのキャラクター
かえさる	カエサル	人名	ガールズ&パンツァーのキャラクター
えるう゛ぃん	エルヴィン	人名	ガールズ&パンツァーのキャラクター
さえもんざ	左衛門佐	人名	ガールズ&パンツァーのキャラクター
おりょう	おりょう	人名	ガールズ&パンツァーのキャラクター
さわあずさ	澤梓	人名	ガールズ&パンツァーのキャラクター
やまごうあゆみ	山郷あゆみ	人名	ガールズ&パンツァーのキャラクター
まるやまさき	丸山紗希	人名	ガールズ&パンツァーのキャラクター
さかぐちかりな	坂口佳利奈	人名	ガールズ&パンツァーのキャラクター
うつぎゆうき	宇津木優季	人名	ガールズ&パンツァーのキャラクター
おおのあや	大野あや	人名	ガールズ&パンツァーのキャラクター
そのみどりこ	園みどり子	人名	ガールズ&パンツァーのキャラクター
そどこ	そど子	名	ガールズ&パンツァー、園みどり子の愛称
ごとうもよこ	後藤モヨ子	人名	ガールズ&パンツァーのキャラクター
ごもよ	ゴモヨ	名	ガールズ&パンツァー、後藤モヨ子の愛称
こんぱるのぞみ	金春希美	人名	ガールズ&パンツァーのキャラクター
ぱぞみ	パゾ美	名	ガールズ&パンツァー、金春希美の愛称
なかじま	ナカジマ	人名	ガールズ&パンツァーのキャラクター
すずき	スズキ	人名	ガールズ&パンツァーのキャラクター
ほしの	ホシノ	人名	ガールズ&パンツァーのキャラクター
つちや	ツチヤ	人名	ガールズ&パンツァーのキャラクター
ねこた	猫田	人名	ガールズ&パンツァーのキャラクター
ねこにゃあ	ねこにゃあ	人名	ガールズ&パンツァーのキャラクター
ももがー	モモガー	人名	ガールズ&パンツァーのキャラクター
ぴおたん	ピオタン	人名	ガールズ&パンツァーのキャラクター
あんこうちーむ	あんこうチーム	組織	ガールズ&パンツァー、チーム名
かめさんちーむ	カメさんチーム	組織	ガールズ&パンツァー、チーム名
あひるさんちーむ	アヒルさんチーム	組織	ガールズ&パンツァー、チーム名
かばさんちーむ	カバさんチーム	組織	ガールズ&パンツァー、チーム名
うさぎさんちーむ	ウサギさんチーム	組織	ガールズ&パンツァー、チーム名
かもさんちーむ	カモさんチーム	組織	ガールズ&パンツァー、チーム名
れおぽんちーむ	レオポンチーム	組織	ガールズ&パンツァー、チーム名
おおあらいじょしがくえん	大洗女子学園	組織	ガールズ&パンツァー、学校名
あんこうおどり	あんこう踊り	固有名詞	ガールズ&パンツァー、その他
