ひだまりすけっち	ひだまりスケッチ	固有名詞	ひだまりスケッチ、タイトル
ゆの	ゆの	名	ひだまりスケッチのキャラクター
ゆのっち	ゆのっち	名	ひだまりスケッチのキャラクター、ゆのの愛称
みやこ	宮子	名	ひだまりスケッチのキャラクター
ひろ	ヒロ	名	ひだまりスケッチのキャラクター
さえ	沙英	名	ひだまりスケッチのキャラクター
のり	乃莉	名	ひだまりスケッチのキャラクター
のりっぺ	乃莉っぺ	名	ひだまりスケッチのキャラクター、乃莉の愛称
のりすけ	乃莉スケ	名	ひだまりスケッチのキャラクター、乃莉の愛称
のりこ	ノリコ	名	ひだまりスケッチのキャラクター、乃莉の愛称
なずな	なずな	名	ひだまりスケッチのキャラクター
まつり	茉里	名	ひだまりスケッチのキャラクター
ふぇすた	フェス太	名	ひだまりスケッチのキャラクター、茉里の愛称
よしのや	吉野家	姓	ひだまりスケッチのキャラクター
くわはら	桑原	姓	ひだまりスケッチのキャラクター
ましこ	益子	姓	ひだまりスケッチのキャラクター
いけざわ	池澤	姓	ひだまりスケッチのキャラクター
みなぐち	皆口	姓	ひだまりスケッチのキャラクター
なつめ	夏目	名	ひだまりスケッチのキャラクター
まみ	真実	名	ひだまりスケッチのキャラクター
なかやま	中山	姓	ひだまりスケッチのキャラクター
きよみ	清美	名	ひだまりスケッチのキャラクター
ありさわ	有沢	姓	ひだまりスケッチのキャラクター
とうどう	藤堂	姓	ひだまりスケッチのキャラクター
きしまいこ	岸麻衣子	人名	ひだまりスケッチのキャラクター
にゃんた	ニャン太	名	ひだまりスケッチのキャラクター
みうら	三浦	姓	ひだまりスケッチのキャラクター
ゆう	優	名	ひだまりスケッチのキャラクター
まなみん	まなみん	名	ひだまりスケッチのキャラクター
みゆき	美雪	名	ひだまりスケッチのキャラクター
けんと	健人	名	ひだまりスケッチのキャラクター
おりべ	折部	姓	ひだまりスケッチのキャラクター
ちか	智花	名	ひだまりスケッチのキャラクター
みさと	みさと	名	ひだまりスケッチのキャラクター
りり	リリ	名	ひだまりスケッチのキャラクター
なおい	直井	名	ひだまりスケッチのキャラクター
しょこら	ショコラ	名	ひだまりスケッチのキャラクター
ちょこやま	チョコ山	名	ひだまりスケッチのキャラクター
あおむし	あおむし	名	ひだまりスケッチのキャラクター
ゆうた	裕太	名	ひだまりスケッチのキャラクター
まえしま	前島	姓	ひだまりスケッチのキャラクター
うめ	うめ	姓	ひだまりスケッチのキャラクター
うめてんてー	うめてんてー	名	ひだまりスケッチのキャラクター
うめす	ウメス	名	ひだまりスケッチのキャラクター
ひだまりそう	ひだまり荘	組織	ひだまりスケッチの用語
やまぶきこうこう	やまぶき高校	組織	ひだまりスケッチの用語
べりまーと	ベリマート	組織	ひだまりスケッチの用語
だだまーと	ダダマート	組織	ひだまりスケッチの用語
まさのゆ	正の湯	組織	ひだまりスケッチの用語
とうかがわ	桃花川	地名	ひだまりスケッチの地名
あいむほーむ	アイムホーム	組織	ひだまりスケッチの用語
ですてぃにーらんど	デスティニーランド	組織	ひだまりスケッチの用語
ちょうこくのはらびじゅつかん	彫刻野原美術館	組織	ひだまりスケッチの用語
ひだまりらじお	ひだまりラジオ	固有名詞	ひだまりスケッチの用語
すけっちすいっち	スケッチスイッチ	固有名詞	ひだまりスケッチオープニング
めばえどらいぶ	芽生えドライブ	固有名詞	ひだまりスケッチエンディングテーマ
