しののめなの	東雲なの	人名	日常のキャラクター
はかせ	はかせ	名	日常のキャラクター
さかもとさん	阪本さん	姓	日常のキャラクター
さかもと	阪本	姓	日常のキャラクター
あいおいゆうこ	相生祐子	人名	フルネーム,日常のキャラクター
ゆっこ	ゆっこ	名	日常のキャラクター、相生祐子の愛称
ながのはらみお	長野原みお	人名	フルネーム,日常のキャラクター
ちゃんみお	ちゃんみお	名	長野原みおの愛称,日常のキャラクター
みなかみまい	水上麻衣	人名	日常のキャラクター
こうちょうせんせい	校長先生	人名	日常のキャラクター
きょうとうせんせい	教頭先生	人名	日常のキャラクター
ささはらこうじろう	笹原幸治郎	人名	日常のキャラクター
たちばなみさと	立花みさと	人名	日常のキャラクター
さくらいせんせい	桜井先生	人名	日常のキャラクター
たかさきせんせい	高崎先生	人名	日常のキャラクター
なかのじょうつよし	中之条剛	人名	日常のキャラクター
たなか	田中	姓	姓,日常のキャラクター
あんなかさん	安中さん	姓	姓,日常のキャラクター
あんなかはるな	安中榛名	人名	日常のキャラクター
とみおかせんせい	富岡先生	人名	日常のキャラクター
さくらいまこと	桜井誠	人名	日常のキャラクター
だいくけんざぶろう	大工健三郎	人名	日常のキャラクター
ふるやしずか	古谷静佳	人名	日常の声優、東雲なのCV
こんのひろみ	今野宏美	人名	日常の声優、はかせCV
しらいしみのる	白石稔	人名	日常の声優、阪本さんCV
ほんだまりこ	本多真梨子	人名	日常の声優、相生祐子CV
あいざわまい	相沢舞	人名	日常の声優、長野原みおCV
とがしみすず	富樫美鈴	人名	日常の声優、水上麻衣CV
ちょー	チョー	人名	日常の声優、校長先生CV
なかひろし	中博史	人名	日常の声優、教頭先生CV
かわはらよしひさ	川原慶久	人名	日常の声優、笹原幸治郎CV
ほりかわちか	堀川千崋	人名	日常の声優、立花みさとCV
こすげまみ	小菅真美	人名	日常の声優、桜井先生CV
いなだとおる	稲田徹	人名	日常の声優、高崎先生CV
やまもとかずとみ	山本和臣	人名	日常の声優、中之条剛CV
やまぐちこうた	山口浩太	人名	日常の声優、田中CV
さどはらかおり	左土原かおり	人名	日常の声優、安中さんCV
ながさこたかし	長嶝高士	人名	日常の声優、富岡先生CV
ひかみたかひろ	比上孝浩	人名	日常の声優、桜井誠CV
よしざきりょうた	吉崎亮太	人名	日常の声優、大工健三郎CV
にちじょうのらじお	「日常」のラヂオ	固有名詞	日常のセクションタイトル
やるき	やる気	名詞	日常のセクションタイトル
にちじょうの	日常の	連体詞	日常のセクションタイトル
へるべてぃかすたんだーど	Helvetica Standard	固有名詞	日常のセクションタイトル
ひとことわどことば	ヒトコトワドコトバ	固有名詞	日常のセクションタイトル
いごさっかーぶ	囲碁サッカー部	組織	日常のセクションタイトル
わら	わら	名詞	日常のセクションタイトル
まぁまぁのきせき	まぁまぁの奇跡	固有名詞	日常のセクションタイトル
らぶてき	ラブ的	固有名詞	日常のセクションタイトル
だいふくふぇあ	大福フェア	固有名詞	日常のセクションタイトル
しんじん	新人	名詞	日常のセクションタイトル
たいいくかんうら	体育館裏	固有名詞	日常のセクションタイトル
わんだふる	ワンダフル	固有名詞	日常のセクションタイトル
ぼたん	ボタン	固有名詞	日常のセクションタイトル
ようけんとようけん	要件と用件	固有名詞	日常のセクションタイトル
ぐりこ	グリコ	固有名詞	日常のセクションタイトル
じゅもん	呪文	固有名詞	日常のセクションタイトル
かたづけ	片付け	固有名詞	日常のセクションタイトル
せいとしどう	生徒指導	固有名詞	日常のセクションタイトル
あましょく	甘食	固有名詞	日常のセクションタイトル
たなか	田中	固有名詞	日常のセクションタイトル
いんこ	インコ	固有名詞	日常のセクションタイトル
なかのじょう	中之条	固有名詞	日常のセクションタイトル
だにゃん	だにゃん	固有名詞	日常のセクションタイトル
だるまおとし	だるま落とし	固有名詞	日常のセクションタイトル
こっくりさん	こっくりさん	固有名詞	日常のセクションタイトル
ほいこーろー	ホイコーロー	固有名詞	日常のセクションタイトル
じゅうえんさっかー	10円サッカー	固有名詞	日常のセクションタイトル
10かぞえたら	10数えたら	固有名詞	日常のセクションタイトル
たからくじ	宝くじ	固有名詞	日常のセクションタイトル
ぷれぜんと	プレゼント	固有名詞	日常のセクションタイトル
そうぞう	想像	固有名詞	日常のセクションタイトル
かけこみじょうしゃはきけんです	駆け込み乗車は危険です	固有名詞	日常のセクションタイトル
なににしましょ	何にしましょ	固有名詞	日常のセクションタイトル
たんじょうびぷれぜんと	誕生日プレゼント	固有名詞	日常のセクションタイトル
ぽっぷこーん	ポップコーン	固有名詞	日常のセクションタイトル
すたーと	スタート	固有名詞	日常のセクションタイトル
しっぽ	しっぽ	固有名詞	日常のセクションタイトル
いちのびー	1-B	固有名詞	日常のセクションタイトル
まめてすと	豆テスト	固有名詞	日常のセクションタイトル
がまん	我慢	固有名詞	日常のセクションタイトル
か	蚊	固有名詞	日常のセクションタイトル
だるまさんがころんだ	だるまさんがころんだ	固有名詞	日常のセクションタイトル
しゃぼん	シャボン	固有名詞	日常のセクションタイトル
むてきせいじん	無敵星人	固有名詞	日常のセクションタイトル
ぶるーのーと	ブルーノート	固有名詞	日常のセクションタイトル
なさ	ナサ	固有名詞	日常のセクションタイトル
かわつり	川釣り	固有名詞	日常のセクションタイトル
だいくりょく	大工力	固有名詞	日常のセクションタイトル
まにー	マニー	固有名詞	日常のセクションタイトル
つぎ、さかもとね	次、阪本ね	固有名詞	日常のセクションタイトル
ひらける	開ける	固有名詞	日常のセクションタイトル
なつい	ナツい	固有名詞	日常のセクションタイトル
かんようく	慣用句	固有名詞	日常のセクションタイトル
めいし	名刺	固有名詞	日常のセクションタイトル
じどうはんばいき	自動販売機	固有名詞	日常のセクションタイトル
いずみ	泉	固有名詞	日常のセクションタイトル
はしおき	箸置き	固有名詞	日常のセクションタイトル
ひまげーむ	暇ゲーム	固有名詞	日常のセクションタイトル
ついつい	ついつい	固有名詞	日常のセクションタイトル
80てんもんごりあん	80点モンゴリアン	固有名詞	日常のセクションタイトル
こつ	コツ	固有名詞	日常のセクションタイトル
げんじつ	現実	固有名詞	日常のセクションタイトル
のりのり	ノリノリ	固有名詞	日常のセクションタイトル
えでん	エデン	固有名詞	日常のセクションタイトル
うらない	占い	固有名詞	日常のセクションタイトル
きになる	気になる	固有名詞	日常のセクションタイトル
にちじょうの57てん5	日常の57.5	固有名詞	日常のセクションタイトル
くつ	くつ	固有名詞	日常のセクションタイトル
ばでぃ	バディ	固有名詞	日常のセクションタイトル
せいしゅん	青春	固有名詞	日常のセクションタイトル
なかむらせんせい、かいろしょーとくん	中村先生、回路ショート君	固有名詞	日常のセクションタイトル
おぐりきゃっぷってこんなの	オグリキャップってこんなの	固有名詞	日常のセクションタイトル
おもちかえり	おもちかえり	固有名詞	日常のセクションタイトル
きゃっちぼーる	キャッチボール	固有名詞	日常のセクションタイトル
てぃこまーと	ティコマート	固有名詞	日常のセクションタイトル
こじろうってこんなの	コジロウってこんなの	固有名詞	日常のセクションタイトル
15ねんめのしんじつ	15年目の真実	固有名詞	日常のセクションタイトル
ちっちっってこんなの	チッチってこんなの	固有名詞	日常のセクションタイトル
こたつ	こたつ	固有名詞	日常のセクションタイトル
なかむらせんせい	中村先生	固有名詞	日常のセクションタイトル
くれーんげーむ	クレーンゲーム	固有名詞	日常のセクションタイトル
からすってこんなの	カラスってこんなの	固有名詞	日常のセクションタイトル
ねる	寝る	固有名詞	日常のセクションタイトル
ぼらんてぃあせいしん	ボランティア精神	固有名詞	日常のセクションタイトル
ほわいとたいがーってこんなの	ホワイトタイガーってこんなの	固有名詞	日常のセクションタイトル
へのへの	へのへの	固有名詞	日常のセクションタイトル
ふうき	風紀	固有名詞	日常のセクションタイトル
めんろんぱん	メロンパン	固有名詞	日常のセクションタイトル
ぴょんってこんなの	ピョンってこんなの	固有名詞	日常のセクションタイトル
ああ、これもせいしゅん	嗚呼、これも青春	固有名詞	日常のセクションタイトル
にちようびのよる	日曜日の夜	固有名詞	日常のセクションタイトル
くんりん	君臨	固有名詞	日常のセクションタイトル
とあるくりすますのひとこま	とあるクリスマスの一コマ	固有名詞	日常のセクションタイトル
わな	ワナ	固有名詞	日常のセクションタイトル
じゆうへのしっそう	自由への疾走	固有名詞	日常のセクションタイトル
いちばんのりそりっど	一番のりソリッド	固有名詞	日常のセクションタイトル
あくしでんと	アクシデント	固有名詞	日常のセクションタイトル
だれかたすけてください	誰か助けて下さい	固有名詞	日常のセクションタイトル
はずす	はずす	固有名詞	日常のセクションタイトル
とぶ	飛ぶ	固有名詞	日常のセクションタイトル
さいみんじゅつ	催眠術	固有名詞	日常のセクションタイトル
かれー	カレー	固有名詞	日常のセクションタイトル
ばーすでー	バースデー	固有名詞	日常のセクションタイトル
こうちょうときょうとう	校長と教頭	固有名詞	日常のセクションタイトル
にちじょうのひめくりしーでぃーその	日常の日めくりＣＤその	固有名詞	日常のセクションタイトル
にちじょうのきゃらくたーそんぐその	日常のキャラクターソング その	固有名詞	日常のセクションタイトル
まいぺーす	麻衣ペース	固有名詞	日常のセクションタイトル
ひゃだいんのかかかたかたおもいしー	ヒャダインのカカカタ☆カタオモイ-C	固有名詞	日常のセクションタイトル
ひゃだいんのじょーじょーゆーじょー	ヒャダインのじょーじょーゆーじょー	固有名詞	日常のセクションタイトル
ぐーぐーぐー	Zzz	固有名詞	日常のセクションタイトル
つばさをください	翼をください	固有名詞	日常のセクションタイトル
ききゅうにのってどこまでも	気球にのってどこまでも	固有名詞	日常のセクションタイトル
まいばらーど	マイ バラード	固有名詞	日常のセクションタイトル
かいじゅうのばらーど	怪獣のバラード	固有名詞	日常のセクションタイトル
ぐりーんぐりーん	グリーングリーン	固有名詞	日常のセクションタイトル
やせいのうま	野生の馬	固有名詞	日常のセクションタイトル
あのすばらしいあいをもういちど	あの素晴らしい愛をもう一度	固有名詞	日常のセクションタイトル
すだちのうた	巣立ちの歌	固有名詞	日常のセクションタイトル
あおげばとおとし	仰げば尊し	固有名詞	日常のセクションタイトル
そらがこんなにあおいとは	空がこんなに青いとは	固有名詞	日常のセクションタイトル
ゆうきひとつをともにして	勇気一つを友にして	固有名詞	日常のセクションタイトル
れっつさーちふぉあつもろー	Let's search for Tomorrow	固有名詞	日常のセクションタイトル
たびだちのひに	旅立ちの日に	固有名詞	日常のセクションタイトル
へっどらいとてーるらいと	ヘッドライト・テールライト	固有名詞	日常のセクションタイトル
なののねじまわしらぷそでぃ	なののネジ回しラプソディ	固有名詞	日常のセクションタイトル
なののおひるねおせんたく	なののおひるねおせんたく	固有名詞	日常のセクションタイトル
はかせのすきなのなの	はかせの好きなのなの	固有名詞	日常のセクションタイトル
はかせのさめといぬ	はかせのサメといぬ	固有名詞	日常のセクションタイトル
さかもとさんのにゃーというとでもおもったか	坂本さんのニャーというとでも思ったか	固有名詞	日常のセクションタイトル
さかもとさんのねこじぇらしー	坂本さんのねこじぇらしー	固有名詞	日常のセクションタイトル
みおのかぷってかぷってもえちぎれ	みおのカプってカプって萌えちぎれ	固有名詞	日常のセクションタイトル
ゆっこはほんとにばかだなあ	ゆっこはほんとにバカだなあ	固有名詞	日常のセクションタイトル
ゆっこのすらまっぱぎだよじんせいは	ゆっこのスラマッパギだよ人生は	固有名詞	日常のセクションタイトル
ゆっこのぎゃぐひゃくれんぱつ	ゆっこのギャグ百連発	固有名詞	日常のセクションタイトル
まいのなみだのあみだにょらい	麻衣の涙の阿弥陀如来	固有名詞	日常のセクションタイトル
まいのかかかたかたおもいぼん	麻衣のカカカタ☆カタオモイー梵	固有名詞	日常のセクションタイトル
ささはらのこじろうぽるか	笹原のコジロウポルカ	固有名詞	日常のセクションタイトル
ささはらのさくらまうときさだ	笹原の桜舞う時定	固有名詞	日常のセクションタイトル
みさとのがっこうせいかつはばくはつだっ	みさとの学校生活は爆発だっ!!	固有名詞	日常のセクションタイトル
みさとのおしえてふぇっちゃんうぇぼしー	みさとの教えてフェっちゃんウェボシー	固有名詞	日常のセクションタイトル
にちじょうのまち	日常のまち	固有名詞	日常のセクションタイトル
だいいとくみょうおうのてーま	大威徳明王のテーマ	固有名詞	日常のセクションタイトル
あんなかのぴょんぴょんえー	安中のぴょん!ぴょん!エー!!	固有名詞	日常のセクションタイトル
せきぐちゆりあのせんぱいといごさっかーぶ	関口ユリアの先輩と囲碁サッカー部	固有名詞	日常のセクションタイトル
さくらいせんせいのどきどきせいとしどう	桜井先生のドキドキ生徒指導	固有名詞	日常のセクションタイトル
なかむらせんせいのかがくのなのもとに!	中村先生の科学の名のもとに!	固有名詞	日常のセクションタイトル
こうちょうのちょーちょーこうちょう	校長のチョーチョー校長	固有名詞	日常のセクションタイトル
ときさだめ	時定	固有名詞	日常のセクションタイトル
ときさだめこうこう	時定高校	固有名詞	日常のセクションタイトル
