あかおにぷろだくしょん	赤鬼プロダクション	組織	
あっぷ	UP	名詞	
あにめーしょん	アニメーション	名詞	
あにめーたー	アニメーター	名詞	
あにめせいさくかいしゃ	アニメ制作会社	名詞	
あふれこ	アフレコ	名詞	
あまぞんしろべこ	アマゾン白べこ	固有名詞	
あるぴん	あるぴん	名	
あんどうつばき	安藤つばき	人名	
いぐちゆみ	井口祐未	人名	
いとうすずか	伊藤鈴鹿	人名	
いまいみどり	今井みどり	人名	
いれきり	入れ切り	名詞	
いろつき	色付き	名詞	
うえすたんえんたていんめんと	ウエスタンエンタテインメント	組織	
うちだあかね	内田茜	人名	
うるりん	Oirrin	組織	
えーぱーと	Aパート	名詞	
えいぞうせいさく	映像制作	名詞	
えくそだす	えくそだす!	固有名詞	
えこんて	絵コンテ	名詞	
えこんてさつ	絵コンテ撮	名詞	
えんしゅつか	演出家	名詞	
おーでぃしょん	オーディション	名詞	
おーるこんてさつ	オールコンテ撮	名詞	
おがさわらりんこ	小笠原綸子	人名	
おきつゆか	興津由佳	人名	
おちあいたつや	落合達也	人名	
おとかん	音響監督	名詞	
おともどし	音戻し	名詞	
おのうえまさと	尾之上将人	人名	
おれさまのはーれむがすこしずつほうかいしているかもしれないけどたぶんきのうせいかもしれないかっこかり	俺様のハーレムが少しずつ崩壊してるかもしれないけどたぶん気のせいかもしれない(仮)	固有名詞	
おれのてづくりろぼっとがししゅんきでたいへんです	俺の手作りロボットが思春期で大変です	固有名詞	
おんきょうかんとく	音響監督	名詞	
おんきょうこうか	音響効果	名詞	
おんきょうせいさく	音響制作	名詞	
おんそくのきふじん	音速の貴婦人	固有名詞	
かーぼんせん	カーボン線	名詞	
かくわさっかん	各話作監	名詞	
かっとぶくろ	カット袋	名詞	
かみやまこうこうあにめーしょんどうこうかい	上山高校アニメーション同好会	組織	
かめらわーく	カメラワーク	名詞	
からやなむい	茅菜夢衣	人名	
かんとく	監督	名詞	
かんのみつあき	菅野光明	人名	
かんぱけ	完パケ	名詞	
がや	ガヤ	名詞	
きさみつひで	木佐光秀	人名	
きたのさぶろう	北野三郎	人名	
きのしたせいいち	木下誠一	人名	
きゃくほんか	脚本家	名詞	
きゃさりん	キャサリン	名	
きゃらくたーげんあん	キャラクター原案	名詞	
きゃらくたーでざいん	キャラクターデザイン	名詞	
きゅーらんぷ	キューランプ	名詞	
くのぎあい	久乃木愛	人名	
くりんなっぷ	クリンナップ	名詞	
ぐろす	グロス	名詞	
ぐろすうけ	グロス請け	名詞	
ぐろすせいさく	グロス制作	名詞	
げきはんがっきょく	劇伴楽曲	名詞	
げんがたんとう	原画担当	名詞	
げんがまん	原画マン	名詞	
げんがようし	原画用紙	名詞	
げんさくさいど	原作サイド	名詞	
げんさつ	原撮	名詞	
こんてさつ	コンテ撮	名詞	
ごすろり	ゴスロリ	名詞	
ごすろりさま	ゴスロリ様	名詞	
さーくるかつどう	サークル活動	名詞	
さいかってぃんぐ	再カッティング	名詞	
さかきしずか	坂木しずか	人名	
さくうち	作打ち	名詞	
さくがいん	作画イン	名詞	
さくがぎほう	作画技法	名詞	
さくがぐろす	作画グロス	名詞	
さくがつくえ	作画机	名詞	
さくがぷらん	作画プラン	名詞	
さくがほうかい	作画崩壊	名詞	
さくがりていく	作画リテイク	名詞	
さくげき	作劇	名詞	
さくまひろみ	佐久間ひろみ	人名	
さっかん	作画監督	名詞	
さっかんあっぷ	作監アップ	名詞	
さっかんいれ	作監入れ	名詞	
さっかんさぎょう	作監作業	名詞	
さついれ	撮入れ	名詞	
さつえいいれきり	撮影入れ切り	名詞	
さつえいかんとく	撮影監督	名詞	
さとうさら	佐藤沙羅	人名	
さんじょ	第三飛行少女隊	固有名詞	
しきさいさんぷる	色彩サンプル	名詞	
しきさいせっけい	色彩設計	名詞	
しなりおらいたー	シナリオライター	名詞	
しみゅれーしょんひょう	シミュレーション表	名詞	
しもやなぎゆういちろう	下柳雄一郎	人名	
しろばこ	SHIROBAKO	固有名詞	
しろばこ	白箱	名詞	
しんこうひょう	進行表	名詞	
しんちょくかんり	進捗管理	名詞	
しんぶつこんこうしちふくじん	神仏混淆七福神	固有名詞	
すーぱーめでぃあくりえいしょんず	スーパーメディア・クリエイションズ	組織	
すぎえしげる	杉江茂	人名	
すずききょうこ	鈴木京子	人名	
すたじおかなぶん	スタジオカナブン	組織	
すたじおかなん	スタジオカナン	組織	
すぷらいさー	スプライサー	名詞	
すりーでぃーくりえーたー	3Dクリエーター	名詞	
すりーでぃーしーじー	3DCG	名詞	
せーらーふくとえふすりー	セーラー服とF3	固有名詞	
せいさくいいんかい	制作委員会	名詞	
せいさくいいんかいほうしき	制作委員会方式	名詞	
せいさくしんこう	制作進行	名詞	
せいさくしんこうがしら	制作進行頭	名詞	
せいさくじん	制作陣	名詞	
せいさくすたっふ	制作スタッフ	名詞	
せいさくですく	制作デスク	名詞	
せいさくはん	制作班	名詞	
せいゆう	声優	名詞	
せいゆうぎょう	声優業	名詞	
せいゆうようせいじょ	声優養成所	名詞	
せがわみさと	瀬川美里	人名	
せっていせいさく	設定制作	名詞	
せりふうけ	台詞ウケ	名詞	
せりふしーと	台詞シート	名詞	
せる	セル	名詞	
そうさっかん	総作画監督	名詞	
そうさっかんほ	総作画監督補	名詞	
そうしゅうへん	総集編	名詞	
そうまれな	相馬れな	人名	
そざいかんり	素材管理	名詞	
たいたにっく	タイタニック	固有名詞	
たいむしーと	タイムシート	名詞	
たかなしたろう	高梨太郎	名詞	
たっぷはり	タップ貼り	名詞	
たておまり	縦尾まり	人名	
たんとうへんしゅうしゃ	担当編集者	名詞	
だいいちげんが	第一原画	名詞	
だいさんひこうしょうじょたい	第三飛行少女隊	固有名詞	
だいにげんが	第二原画	名詞	
だんびんぐまえさしかえ	ダビング前差し替え	名詞	
ちぇっくむーびー	チェックムービー	名詞	
ちゃざわのぶすけ	茶沢信輔	人名	
ちょうひこうようかんまじだす	超飛空要艦マジダス	固有名詞	
つめしじ	ツメ指示	名詞	
てがきあにめーたー	手書きアニメーター	名詞	
てろっぷ	テロップ	名詞	
でぃーぜるさん	ディーゼルさん	名詞	
でじたるこんてんつ	デジタルコンテンツ	名詞	
ですく	デスク	名詞	
でんせつきょだいろぼっといでぽん	伝説巨大ロボットイデポン	固有名詞	
とーくばっく	トークバック	名詞	
とうかこうのうらうち	透過光の裏打ち	名詞	
とうどうみさ	藤堂みさ	人名	
とがき	ト書き	名詞	
とれーすだい	トレース台	名詞	
どーなつ	ドーナツ	名詞	
どうがけんさ	動画検査	名詞	
どうじんしそくばいかい	同人誌即売会	名詞	
どうもとちえみ	堂本知恵美	人名	
どりふとそうこう	ドリフト走行	名詞	
なかはるめい	中春鳴	人名	
なかわり	中割り	名詞	
ながいつかさ	永井つかさ	名詞	
なべぴ	ナビP	名詞	
にいかわなお	新川奈緒	人名	
にげん	二原	名詞	
にゃんとわんたろー	ニャンとワンたろー	固有名詞	
のうひん	納品	名詞	
のがめむさし	野亀武蔵	人名	
はだかのさいみんじゅつし	裸の催眠術師	固有名詞	
はにーとくろーばー	ハニーとクローバー	固有名詞	
はれーしょん	ハレーション	名詞	
はんどうたつや	半藤達也	人名	
ばくはつえふぇくと	爆発エフェクト	名詞	
ばでぃ	相棒	名詞	
ばらちぇっく	バラチェック	名詞	
ばんさくつきたー	万策尽きたー!	感動詞	
ぱーす	パース	名詞	
ぱーすぺくてぃぶ	パースペクティブ	名詞	
ひょうじょうしゅうせい	表情修正	名詞	
ひらおかだいすけ	平岡大輔	人名	
びーじーうち	BG打ち	名詞	
びーぱーと	Bパート	名詞	
びじゅつぼーど	美術ボード	名詞	
びじゅつまん	美術マン	名詞	
ふりっかー	フリッカー	名詞	
ふろーちゃーと	フローチャート	名詞	
ぶいへん	V編	名詞	
ぶらっしゅあっぷ	ブラッシュアップ	名詞サ変	
ぶれす	ブレス	名詞	
ぷるんぷるんてんごく	ぷるんぷるん天国	固有名詞	
ぷれす	プレス	名詞サ変	
ぷろっと	プロット	名詞	
ほうじょうひろあき	北条弘明	人名	
ほったひかる	堀田光	人名	
ほんだゆたか	本田豊	人名	
ほんよみ	本読み	名詞	
ぼーどちぇっく	ボードチェック	名詞サ変	
ぼいすおーばー	ボイスオーバー	名詞サ変	
ぼうえんきどうたい	望遠機動隊	固有名詞	
ぽりごん	ポリゴン	名詞	
まいたけしめじ	舞茸しめじ	人名	
まつてい	松亭	固有名詞	
まるかわまさと	丸川正人	人名	
みきさー	ミキサー	名詞	
みきさーじょしゅ	ミキサー助手	名詞	
みむじー	ミムジー	名	
みむじーあんどろろ	ミムジー＆ロロ	固有名詞	
みゃーもり	みゃーもり	名	
みやもりあおい	宮森あおい	人名	
みやもりかおり	宮森かおり	人名	
むさしのあにめーしょん	武蔵野アニメーション	組織	
むさしのどうが	武蔵野動画	組織	
めーかーぴー	メーカーP	名詞	
めーかーぷろでゅーさー	メーカープロデューサー	名詞	
めぱち	目パチ	名詞	
もーしょんぶらー	モーションブラー	名詞	
もえけい	萌え系	名詞	
もりしのぶ	森しのぶ	人名	
やすはらえま	安原絵麻	人名	
やのえりか	矢野エリカ	人名	
やまだまさし	山田昌志	人名	
やまはりねずみあんですちゃっきー	山はりねずみアンデスチャッキー	名詞	
よたかしょぼう	夜鷹書房	組織	
らいんでぃれくたー	ラインディレクター	名詞	
らいんぴー	ラインP	名詞	
らいんぷろでゅーさー	ラインプロデューサー	名詞	
らっしゅちぇっく	ラッシュチェック	名詞	
らふげん	ラフ原	名詞	
りすけ	リスケ	名詞	
りていく	リテイク	名詞サ変	
りんこはん	綸子はん	名	
るーしー	ルーシー	名	
ろーぽり	ローポリ	名詞	
ろけはん	ロケハン	名詞	
ろろ	ロロ	名	
わたなべしゅん	渡辺隼	人名	
