そーどあーとおんらいん	ソード・アート・オンライン	固有名詞	ソード・アート・オンライン、題名
そーどあーとおんらいん	Sword Art Online	固有名詞	ソード・アート・オンライン、題名(英語表記)
そーどあーとおんらいん	SAO	固有名詞	ソード・アート・オンライン、題名(略称)
あいんくらっど	アインクラッド	固有名詞	ソード・アート・オンライン、ストーリー名
ふぇありぃだんす	フェアリィ・ダンス	固有名詞	ソード・アート・オンライン、ストーリー名
ふぁんとむばれっと	ファントム・バレット	固有名詞	ソード・アート・オンライン、ストーリー名
まざーずろざりお	マザーズ・ロザリオ	固有名詞	ソード・アート・オンライン、ストーリー名
あーりーあんどれいと	アーリー・アンド・レイト	固有名詞	ソード・アート・オンライン、ストーリー名
ありしぜーしょん	アリシゼーション	固有名詞	ソード・アート・オンライン、ストーリー名
きりと	Kirito	名	ソード・アート・オンライン、アバター名
あすな	Asuna	名	ソード・アート・オンライン、アバター名
ゆい	Yui	名	ソード・アート・オンライン、アバター名
りーふぁ	Lyfa	名	ソード・アート・オンライン、アバター名
くらいん	Klein	名	ソード・アート・オンライン、アバター名
えぎる	Agil	名	ソード・アート・オンライン、アバター名
しりか	Silica	名	ソード・アート・オンライン、アバター名
ぴな	Pina	名	ソード・アート・オンライン、アバター名
りずべっと	Lisbeth	名	ソード・アート・オンライン、アバター名
しのん	Sinon	名	ソード・アート・オンライン、アバター名
ひーすくりふ	Heathcliff	名	ソード・アート・オンライン、アバター名
きりと	キリト	名	ソード・アート・オンライン、アバター名(カタカナ表記)
あすな	アスナ	名	ソード・アート・オンライン、アバター名(カタカナ表記)
ゆい	ユイ	名	ソード・アート・オンライン、アバター名(カタカナ表記)
りーふぁ	リーファ	名	ソード・アート・オンライン、アバター名(カタカナ表記)
くらいん	クライン	名	ソード・アート・オンライン、アバター名(カタカナ表記)
えぎる	エギル	名	ソード・アート・オンライン、アバター名(カタカナ表記)
しりか	シリカ	名	ソード・アート・オンライン、アバター名(カタカナ表記)
ぴな	ピナ	名	ソード・アート・オンライン、アバター名(カタカナ表記)
りずべっと	リズベット	名	ソード・アート・オンライン、アバター名(カタカナ表記)
しのん	シノン	名	ソード・アート・オンライン、アバター名(カタカナ表記)
ひーすくりふ	ヒースクリフ	名	ソード・アート・オンライン、アバター名(カタカナ表記)
きりがやかずと	桐ケ谷和人	人名	ソード・アート・オンライン、フルネーム
ゆうきあすな	結城明日奈	人名	ソード・アート・オンライン、フルネーム
きりがやすぐは	桐ケ谷直葉	人名	ソード・アート・オンライン、フルネーム
あんどりゅーぎるばーとみるず	アンドリュー・ギルバート・ミルズ	人名	ソード・アート・オンライン、フルネーム
あやのけいこ	綾野珪子	人名	ソード・アート・オンライン、フルネーム
しのざきりか	篠崎理香	人名	ソード・アート・オンライン、フルネーム
あさだしの	朝田詩乃	人名	ソード・アート・オンライン、フルネーム
かやばあきひこ	茅場晶彦	人名	ソード・アート・オンライン、フルネーム
さち	サチ	名	ソード・アート・オンライン、アバター名(カタカナ表記)
けいた	ケイタ	名	ソード・アート・オンライン、アバター名(カタカナ表記)
てつお	テツオ	名	ソード・アート・オンライン、アバター名(カタカナ表記)
ささまる	ササマル	名	ソード・アート・オンライン、アバター名(カタカナ表記)
だっかー	ダッカー	名	ソード・アート・オンライン、アバター名(カタカナ表記)
ぷー	PoH	名	ソード・アート・オンライン、アバター名
ざざ	Xaxa	名	ソード・アート・オンライン、アバター名
じょにーぶらっく	ジョニー・ブラック	名	ソード・アート・オンライン、アバター名(カタカナ表記)
ぷー	プー	名	ソード・アート・オンライン,アバター名(カタカナ表記)
ざざ	ザザ	名	ソード・アート・オンライン,アバター名(カタカナ表記)
かなもとあつし	金本敦	人名	ソード・アート・オンライン,フルネーム
しんかわしょういち	新川昌一	人名	ソード・アート・オンライン,フルネーム
しんかー	シンカー	名	ソード・アート・オンライン、アバター名(カタカナ表記)
ゆりえーる	ユリエール	名	ソード・アート・オンライン、アバター名(カタカナ表記)
きばおう	キバオウ	名	ソード・アート・オンライン、アバター名(カタカナ表記)
こーばっつ	コーバッツ	名	ソード・アート・オンライン、アバター名(カタカナ表記)
ぐりせるだ	グリセルダ	名	ソード・アート・オンライン、アバター名(カタカナ表記)
よるこ	ヨルコ	名	ソード・アート・オンライン、アバター名(カタカナ表記)
かいんず	カインズ	名	ソード・アート・オンライン、アバター名(カタカナ表記)
しゅみっと	シュミット	名	ソード・アート・オンライン、アバター名(カタカナ表記)
ぐりむろっく	グリムロック	名	ソード・アート・オンライン、アバター名(カタカナ表記)
あるご	アルゴ	名	ソード・アート・オンライン、アバター名(カタカナ表記)
にしだ	ニシダ	名	ソード・アート・オンライン、アバター名(カタカナ表記)
さーしゃ	サーシャ	名	ソード・アート・オンライン、アバター名(カタカナ表記)
みな	ミナ	名	ソード・アート・オンライン、アバター名(カタカナ表記)
ぎん	ギン	名	ソード・アート・オンライン、アバター名(カタカナ表記)
けいん	ケイン	名	ソード・アート・オンライン、アバター名(カタカナ表記)
でぃあべる	ディアベル	名	ソード・アート・オンライン、アバター名(カタカナ表記)
ろざりあ	ロザリア	名	ソード・アート・オンライン、アバター名(カタカナ表記)
おべいろん	オベイロン	名	ソード・アート・オンライン、アバター名(カタカナ表記)
れこん	レコン	名	ソード・アート・オンライン、アバター名(カタカナ表記)
しぐるど	シグルド	名	ソード・アート・オンライン、アバター名(カタカナ表記)
さくや	サクヤ	名	ソード・アート・オンライン、アバター名(カタカナ表記)
ありしゃるー	アリシャ・ルー	名	ソード・アート・オンライン、アバター名(カタカナ表記)
ゆーじーん	ユージーン	名	ソード・アート・オンライン、アバター名(カタカナ表記)
かげむね	カゲムネ	名	ソード・アート・オンライン、アバター名(カタカナ表記)
じーくたす	ジークタス	名	ソード・アート・オンライン、アバター名(カタカナ表記)
ようせいおうおべいろん	妖精王オベイロン	人名	ソード・アート・オンライン,アバター名(別称)
ながたしんいち	長田伸一	人名	ソード・アート・オンライン,フルネーム
すごうのぶゆき	須郷伸之	人名	ソード・アート・オンライン,フルネーム
つきよのくろねこだん	月夜の黒猫団	組織	ソード・アート・オンライン、団体名
けつめいきしだん	血盟騎士団	組織	ソード・アート・オンライン、団体名
らふぃんこふぃん	ラフィン・コフィン	組織	ソード・アート・オンライン、団体名
わらうかんおけ	笑う棺桶	組織	ソード・アート・オンライン,団体名
あいんくらっどかいほうぐん	アインクラッド解放軍	組織	ソード・アート・オンライン、団体名
おうごんりんご	黄金林檎	組織	ソード・アート・オンライン、団体名
